13,26
39,39,39,39,39,45,10003,46,39,39,39,39,39
411406,6,6,1406,6,6,3,6,6,1406,6,6,401406
6,1506,6,6,6,6,3,6,6,6,6,1506,6
1506,6,6,906,6,6,6,6,6,6,6,6,1506
6,6,6,6,1406,6,280706,6,6,6,1506,6,6
6,1406,6,6,6,6,6,6,1406,6,6,6,6
6,6,6,6,1506,6,6,6,6,6,1406,6,1406
1506,6,1406,6,6,6,6,6,1506,6,6,806,6
6,6,6,6,1406,6,6,6,6,6,6,6,6
371406,6,1506,6,6,6,6,6,6,1406,6,6,1406
1706,1706,1706,1706,1706,1706,2,1706,1706,1706,1706,1706,1706
1706,1706,1706,1706,1706,1706,2,1706,1706,1706,1706,1706,1706
1706,1706,1706,1706,1706,1706,2,1706,1706,1706,1706,1706,1706
1706,1706,1706,1706,1706,1706,2,1706,1706,1706,1706,1706,1706
1706,1706,1706,1706,1706,1706,2,1706,1706,1706,1706,1706,1706
1706,1706,1706,1706,1706,1706,2,1706,1706,1706,1706,1706,1706
1502,1502,1502,1502,1502,1502,2,1502,1502,1502,1502,1502,1502
1502,1502,1502,1502,1502,1502,2,1502,1502,1502,1502,1502,1502
1502,1502,1502,1502,1502,1502,2,1502,1502,1502,1502,1502,1502
1502,1502,1502,1502,1502,1502,2,1502,1502,1502,1502,1502,1502
1502,1502,1502,1502,602,2,2,2,602,1502,1502,1502,1502
1502,1502,1502,1502,2,9,9,9,2,1502,1502,1502,1502
1502,1502,1502,1502,2,9,4408,9,2,1502,1502,1502,1502
1502,1502,1502,1502,2,9,9,9,2,1502,1502,1502,1502
1502,1502,1502,1502,602,2,2,2,602,1502,1502,1502,1502
1502,1502,1502,1502,1502,1502,1502,1502,1502,1502,1502,1502,1502
